r7
c7
WWWWWWW
W P   W
W B   W
W G   W
W GG  W
W     W
WWWWWWW