r8
c8
WWWWWWWW
WOWOOOOW
WGOOOBOW
WOWWOOOW
WOOOOOOW
WOOOOOPW
WOOOOOOW
WWWWWWWW
