r8
c8
WWWWWWWW
W   Q  W
W W WBGW
W    BGW
W W  BGW
W   W  W
WWWWWP W
    WWWW