r8
c8
WWWWWWWW
WOOOOOOW
WWOBOOOW
WWWOOOOW
WOOOOPOW
WOOOOOOW
WOOGOWOW
WWWWWWWW
