r8
c8
WWWWWWWW
WOWOOOOW
WOOOBOOW
WOWWOWOW
WOOOPOOW
WOOOOOOW
WGOOOOOW
WWWWWWWW
