r14
c14
    WWWWWWWW  
  WWW  W   W  
WWW B  B W WWW
W   W BBW    W
WPB     WBWW W
WW BWWWBB    W
 WW  WW WB   W
  WWGGG W BW W
   WGGGGGW B W
   WWGGGGG   W
    WWWW WB WW
       W    W  
       W   WW 
       WWWWW  