r8
c8
WWWWWWWW
WOOOOOOW
WPOOOOOW
WOOOOWOW
WOOBOOOW
WGOOOOOW
WOOOOWOW
WWWWWWWW
