r8
c8
WWWWWWWW
WOPOOOOW
WOGOWOOW
WOOOWWOW
WOOOOOOW
WOOOBOOW
WOOOOOOW
WWWWWWWW
