r8
c8
WWWWWWWW
WOOOPWOW
WOOGOOOW
WOWOOWWW
WOOOOOOW
WOOBOWOW
WOOOOOOW
WWWWWWWW
