r8
c8
WWWWWWWW
WOWOPOOW
WOOOOWOW
WGWWOOOW
WOOOOOOW
WOBOWOOW
WOOOWWOW
WWWWWWWW
