r8
c8
WWWWWWWW
WOWOOWOW
WOOOOOOW
WOWWOWWW
WOOOOOPW
WGOOBOOW
WOOOOWOW
WWWWWWWW
