r8
c8
WWWWWWWW
WOOOPOOW
WOOOOOOW
WOBOOOOW
WOOOOWOW
WGOOOOOW
WOOOOWWW
WWWWWWWW
