r8
c8
WWWWWWWW
WOOOOOPW
WGOOOOOW
WOWOOOOW
WOOOBOOW
WOOOOOOW
WOOOOWOW
WWWWWWWW
