r8
c8
WWWWWWWW
W   W  W
W W WBGW
W    BGW
W W WBGW
W   W  W
WWWWWP W
    WWWW