r6
c12
 WWWW  WWWWW
WW  W  W   W
W   WWWWBB W
W PBGGGGB  W
WW    W   WW
 WWWWWWWWWW 