r8
c8
   WWWWW
 WWW   W
WW   WBW
WW WW  W
WPB    W
W  WWB W
WWWWGGGW
   WWWWW