r9
c9
WWWWWWWW 
W      W 
W WBB  W 
W GGGW W 
WWGGGB WW
 W WW B W
 WB  B  W
 W  W  PW
 WWWWWWWW